XXXXXXXXXXXXXX
X    X   X   X
X XXX X   XX X
X  X  XXX  X X
X X      X   X
X   X   X   XX
X X X X X XXXX
X X  X  X    X
X XX   XX   XX
X    X       X
XXXXXXXXXXXXXX
